   ####################################################################################################################################################
   #                       #  #              #  #  #     #           #        #  #           #              #                 #        #        #  #  #
#  #  ####  ##########  ####  #  #######  #  #  #  ####  #  ####  #######  ####  #  ####  #  #  ####  #  ####  ##########  ####  ####  #  #######  #  #
#        #     #     #  #     #     #  #  #  #     #        #     #     #        #  #     #        #  #  #        #     #  #  #  #     #              #
#############  #  ####  ####  #  ####  ####  ####  ##########  ####  #######  ################  #  #  #############  ####  #  #  #######  #  ##########
#        #  #        #  #                 #        #        #           #              #        #  #     #        #        #        #     #  #  #     #
#  ####  #  #  #  #  #  ####  #  #  ##########  ####  #  ####  #######  ##########  ####  #######  ##########  ####  ####  #  #######  ####  #  #  #  #
#  #  #        #  #  #        #  #        #        #  #     #  #     #  #  #        #  #  #  #  #     #  #     #     #              #     #     #  #  #
#  #  ####  ####  #############  ###################  #  ####  #  ####  #  ####  #  #  ####  #  #  ####  ####  #  #############  #  #  ####  ####  ####
#        #  #        #     #  #     #     #  #  #     #     #        #  #        #  #                                #     #     #     #  #  #        #
##########  #  #######  ####  #  #######  #  #  ####  #######  #######  #  ####  ####  ####  #  #  #  ####  #  ####  #  ####  #######  #  ##########  #
#           #           #  #  #     #     #  #  #  #        #     #     #  #  #           #  #  #  #     #  #  #     #     #  #  #           #     #  #
#########################  #  #  #######  #  #  #  ####  #######  #  ####  #  ################  #  ##########  ####  ####  ####  ##########  ####  #  #
#           #     #  #     #                 #              #     #           #     #     #  #  #     #     #     #  #        #     #     #     #  #  #
#  #  ####  #  ####  ####  #  #  #  ####  #  #  #  #############  #  #  #  ####  #######  #  #  #  #  ####  #  #  ##########  ####  ####  #######  #  #
#  #     #  #  #     #        #  #     #  #  #  #        #  #  #  #  #  #        #  #     #  #  #  #  #        #  #                       #     #     #
####  #######  #  ##########  ##########  ####  ##########  #  ##########  #######  #  ####  ###################  #######  #######  ####  ####  #  #  #
#        #                 #  #        #     #        #        #  #           #                 #     #        #     #     #           #     #     #  #
####  ####  #  #  #  #  ####  ####  #  ##########  #  ####  ####  #######  #  ################  ####  #  ####  ####  #  #############  ####  #######  #
#        #  #  #  #  #     #        #           #  #        #  #  #     #  #  #  #           #     #  #  #  #  #     #  #              #  #  #  #     #
#  ####  #  #######  ###################  ####  ####  #######  #  #  #  #  #  #  ####  #######  ####  #  #  #  #  #  #######  #  ####  #  #  #  #  #  #
#  #     #     #     #     #     #  #  #  #  #        #  #           #  #  #     #  #        #     #  #     #     #        #  #     #  #           #  #
#  #  #  #  #  ####  #  #######  #  #  ####  #  #  #  #  #######  #  ####  ####  #  ####  #######  #  ####  #######  ################  #############  #
#  #  #     #     #           #     #  #     #  #  #  #           #     #  #        #  #        #     #        #           #     #                 #  #
#######  #  #  #######  ##########  #  ####  #  ##########  ####  #############  #  #  #  #######  #  #  ##########  ##########  ####  #  ##########  #
#  #     #  #        #     #              #                 #  #     #  #        #  #  #           #  #  #                 #        #  #     #        #
#  #######  #############  #  #######  #  ################  #  ####  #  #######  ####  #  #  #  ##########  ####  #  ####  ####  ####  #############  #
#        #  #  #           #     #     #     #  #        #     #     #           #     #  #  #  #     #  #  #  #  #  #     #  #        #        #  #  #
#  #  ####  #  ####  ##########  ####  #######  #######  #######  #  ##########  ####  #  #  #  #  #  #  #  #  ####  #  ####  #  ####  #  ####  #  #  #
#  #        #  #     #     #  #  #  #  #     #              #     #  #                    #  #  #  #  #           #  #              #        #     #  #
#############  #  #  #  ####  #  #  #  #  #  ####  #############  #######  ####  #  ##########  #  ##########  ####  ####  ##########  ####  #  ####  #
#           #     #  #  #     #  #        #  #           #  #  #  #  #     #     #  #           #  #     #  #  #        #        #  #     #  #     #  #
#  #  #############  #  #  #  #  ######################  #  #  #  #  #  ####  #  ####  ####  ####  #  #  #  #  #######  #  #  ####  ###################
#  #           #           #  #     #  #     #                 #        #     #  #  #     #           #     #  #        #  #  #        #              #
####  #############  #  #  ####  ####  #  #  #######  #  #  ####  ####  ####  #  #  #  ############################  #######  #  ####  ####  #  #  ####
#                 #  #  #     #        #  #  #     #  #  #        #  #     #  #  #  #  #  #                       #  #           #     #     #  #     #
####  #  ##########  #######  ####  ####  #######  #######  #######  #  #######  #  ####  #  ####  #########################  #######  #  #  ##########
#  #  #  #  #  #        #  #        #                 #        #  #     #     #        #     #           #        #     #  #  #           #     #     #
#  #  #  #  #  #  #######  ####  #######  #######  ####  #  ####  #  ####  ##########  ####  #  #############  #  #  #  #  ##########  #  #  ####  ####
#     #  #  #  #        #        #           #  #  #  #  #        #        #  #  #     #     #                 #     #  #              #  #  #  #     #
#######  #  #  ##########  #  ##########  ####  #  #  #  ################  #  #  ####  #  ####  #  #  #  #  ####  #  ####  ####  ####  ####  #  #  ####
#  #                    #  #     #  #  #  #  #           #  #           #           #  #     #  #  #  #  #     #  #  #  #  #        #  #  #     #     #
#  ####  ####  #######  #  #  ####  #  #  #  #  #  #  ####  #  #######  ####  ##########  ####  ####  #  ####  #  #  #  #############  #  #  #######  #
#        #     #           #              #  #  #  #        #        #        #        #  #     #     #  #  #  #  #  #        #  #        #  #        #
#  ####  ####  #  #  #######  ####  #  #  #  #  #######  #######  #  #######  ####  ####  ####  #######  #  #  ####  #  #  ####  #  ################  #
#     #  #     #  #  #           #  #  #     #        #        #  #     #  #        #  #  #  #        #     #  #     #  #     #     #     #        #  #
#  #######  #############  ####  #  #  ################  #######  #######  #######  #  ####  ####  ################  #  ##########  ####  #######  #  #
#     #     #     #  #  #     #  #  #           #        #           #                    #     #  #  #  #     #  #        #     #     #           #  #
####  ##########  #  #  #  #  ####  #############  #  ####  #  #  #  #  #  ##########  #######  #  #  #  ####  #  #  #######  #  ####  ##########  #  #
#        #  #     #        #  #                 #  #  #     #  #  #  #  #  #  #                    #  #  #           #        #  #  #                 #
#######  #  ####  #  #######  #############  #  #  #  ######################  ##########  ####  #  #  #  #  ####  #######  #  #  #  #  ####  #######  #
#     #     #  #     #  #     #        #  #  #  #  #  #  #  #           #     #           #     #     #        #           #  #  #  #  #           #  #
####  #  #  #  #  ####  #############  #  ##########  #  #  ####  ####  ####  #######  ####  ####  #  #  #######  #######  ####  #  #  #############  #
#        #     #        #           #           #           #  #  #  #  #     #           #  #     #  #     #  #  #        #        #  #  #  #  #     #
#  ####  ####  ##########  #######  ####  ####  #######  ####  #  #  #  ####  ####  ####  #  ##########  ####  #  #######  ####  #  ####  #  #  ####  #
#  #     #     #              #  #  #     #  #  #           #     #  #  #  #  #     #  #  #     #           #     #           #  #  #     #     #     #
#######  ####  #  ##########  #  ####  #  #  #  #  ##########  ####  #  #  #  #  #  #  #  #######  #  #  #  #  ##########  #  ##########  #  ##########
#     #     #  #  #     #           #  #  #     #           #        #  #        #  #  #        #  #  #  #  #           #  #              #  #  #     #
#  ####  #  ####  #  #  #######  ####  #######  #  ##########  #  #  #######  #######  ####  #  ####  ####  ####  #  #  #  #  ####  ####  #  #  ####  #
#     #  #  #        #  #  #                 #        #  #     #  #                 #  #     #  #        #     #  #  #  #  #  #     #  #     #     #  #
#  #  #  #  #############  ##########  #  ##########  #  ####  ####  ################  #############  #############  ##########  ####  ####  #  ####  #
#  #     #     #           #        #  #  #     #     #     #  #           #  #           #     #           #     #  #                    #           #
#  #  #  #############  ##########  ####  ####  ##########  #  ####  #  ####  #  #############  ####  #  ####  ####  ##########  #######  #  ##########
#  #  #  #        #     #  #        #        #        #        #  #  #  #  #  #           #  #     #  #        #  #  #  #     #  #        #           #
#######  #  ####  #  ####  ####  ##########  ####  ####  ####  #  ####  #  #  #  ####  ####  ####  #############  ####  ####  ##########  #  ##########
#              #        #     #        #              #     #  #              #  #  #     #  #  #           #        #        #     #  #  #  #  #     #
#  ##########  ####  #######  #######  #  #  #  #######  ####  #  ##########  #  #  #######  #  #  #  ####  #######  #  #  ####  ####  #######  ####  #
#  #     #        #  #                    #  #  #     #     #  #           #  #           #  #     #     #  #        #  #     #                 #     #
#  #  ####  #  ##########  ################  #  ####  ##########  #  #######  #######  ####  #  ###################  #  ################  #######  ####
#  #  #  #  #     #        #     #           #     #     #        #  #  #  #  #                    #     #        #        #        #  #              #
#  #  #  #  #######  ####  ####  #  ####  #  #  ####  ####  ####  #  #  #  #  ####  #######  ####  ####  #######  #  ####  #  ####  #  #  #  ####  #  #
#        #        #  #  #     #  #  #     #  #           #  #     #  #     #  #  #  #        #           #        #     #  #  #  #  #  #  #  #     #  #
#  ################  #  #######  #######  ####  #  #  ####  ##########  #######  #  #############  #  ##########  #  #  ####  #  #  #  #  #  ####  ####
#        #     #           #     #  #  #     #  #  #  #  #           #  #     #           #     #  #                 #  #        #        #  #        #
#  ####  #  ####  #######  #  ####  #  #  #  ####  ####  ##########  #  ####  #  ##########  #  #  #############  ####  ####  ####  ###################
#  #     #              #  #  #  #  #     #     #  #  #  #  #     #  #                    #  #  #           #     #  #  #     #  #     #              #
#  #  #  ################  #  #  #  #  ####  #######  #  #  ####  #  #######  ####  #######  ####  ####  #  #  #  #  #######  #  #  ##########  ####  #
#  #  #  #     #  #           #        #     #        #              #     #  #     #        #        #  #  #  #     #        #           #  #  #     #
#  ##########  #  ####  #  #  ######################  #  ####  #  #  ####  #  ####  #  #######  #  ####  #######  ####  #  ##########  #  #  ####  #  #
#  #        #     #  #  #  #                 #     #     #     #  #  #  #     #           #     #     #  #     #     #  #     #  #  #  #           #  #
####  #  #  #  #  #  #######  ####  #######  #  ####  #  #############  #######  ####  #  ##########  #  ####  ####  #######  #  #  #######  #  #  ####
#     #  #     #  #           #     #           #     #           #           #     #  #        #     #  #        #  #  #  #        #        #  #  #  #
#  #############  ####  #  ###################  #######  ####  #  ####  #  ##########  ####  ##########  #######  ####  #  #  #  #  #  #############  #
#  #  #  #  #     #  #  #     #              #        #     #  #  #  #  #  #     #        #     #  #                 #  #     #  #  #  #        #     #
#  #  #  #  #  #  #  ####  #  #  #  ###################  #  #  #  #  #  ####  #######  ####  ####  #############  ####  ####  ####  #  #  ####  #  ####
#  #  #  #     #  #  #  #  #  #  #           #  #  #  #  #  #  #     #  #        #     #  #  #                 #     #           #  #  #  #     #     #
#  #  #  #  #######  #  ####  #  #  #  ####  #  #  #  ####  ##########  ####  #  #  ####  #  #  #######  #  #  #############  ####  #  ####  #######  #
#  #     #        #        #  #  #  #  #     #     #     #        #     #  #  #     #                 #  #  #              #     #  #                 #
#######  ####  ####  ######################  #  ####  #######  #  ####  #  ####  #######  ####  #  #######  #  #  #######  ##########  #  ##########  #
#  #  #     #        #     #        #        #     #     #     #     #        #  #  #     #  #  #        #  #  #     #  #  #           #  #  #        #
#  #  ####  ####  ####  #  #######  #######  #  #  #  #  ##########  #  #######  #  #######  ####  #  ####  #######  #  #  #  #  #  #######  #  #######
#     #     #  #        #                 #     #     #        #                       #  #        #     #     #     #     #  #  #           #        #
####  #  ####  ####  ##########  #######  ####  ####  ####  ####  #######  #  ####  ####  ##########  #  #######  #############  #######  #######  ####
#              #        #     #  #     #        #        #     #  #  #     #     #     #        #  #  #  #     #           #  #     #  #  #     #     #
#############  #######  ####  #  ####  #############  ##########  #  ####  ####  #######  #######  #######  ####  #  #######  #  ####  ####  #  #  ####
#  #     #           #  #     #                    #        #  #  #        #  #        #     #     #  #        #  #           #           #  #        #
#  #  ##########  #  #  #  ##########  #######  #############  #######  ####  #  #  #  #  #  #  ####  #  #  ####  ##########  #  ####  ##########  ####
#                 #        #     #  #        #  #     #     #     #     #  #  #  #  #  #  #  #     #  #  #              #  #  #  #        #           #
#######  ####  #  #  #######  ####  #  #############  #  #  ####  #######  #  ##########  #######  #  ####  #######  ####  #######  ####  ####  #######
#        #     #  #     #                                #                                                     #                       #     #        
####################################################################################################################################################  