***############################
  *      #  #  #*****#        #
# *#######  #  #* # *#  ####  #
# *************** # *#  #     #
####  #######  #### *#  ####  #
#           #     # *   #     #
#  #######  #  #### *#######  #
#  #        #  #    *#        #
#############  #### *##########
#  #  #           # ****   #  #
#  #  #  #######  #### *####  #
#  #  #     #  #  # ****      #
#  #  #  ####  #### *#######  #
#  #  #        #    ****#     #
#  #  #  #  #######  # *#  ####
#  #     #     #     # *#     #
#  #  ################ *#######
#              #       *******#
####  #  ####  ####  #  #### *#
#     #  #     #     #  #    **
############################  *
